Aarhus	Denmark
Agadir	Morocco
Alghero	Italy
Alicante	Spain
Almeria	Spain
Ancona	Italy
Athens	Greece
Baden-Baden	Germany
Barcelona-El-Prat	Spain
Bari	Italy
Basel	Switzerland
Bergerac	France
Berlin-Schonefeld	Germany
Beziers	France
Biarritz	France
Billund	Denmark
Birmingham	Great-Britain
Bolonha	Italy
Bordeaux	France
Bournemouth	Great-Britain
Bratislava	Slovakia
Bremen	Germany
Brest	France
Brindisi	Italy
Bristol	Great-Britain
Brive	France
Brno	Czech-Republic
Brussels-Zaventem	Belgium
Brussels-Charleroi	Belgium
Bucharest-Otopeni	Romania
Budapeste	Hungary
Bydgoszcz	Poland
Cagliari	Italy
Carcassonne	France
Cardiff	Great-Britain
Castellon	Spain
Catania	Italy
Cefalonia	Greece
Chania	Greece
Clermont-Ferrand	France
Colonia	Germany
Comiso	Italy
Copenhaga	Denmark
Corfu	Greece
Cork	Ireland
Cos	Greece
Cracovia	Poland
Crotone	Italy
Cuneo	Italy
Deauville-Normandia	France
Derry	Great-Britain
Dinard	France
Dole	France
Dortmund	Germany
Dublin	Ireland
Dusseldorf-Weeze	Germany
East-Midlands	Great-Britain
Edinburgo	Great-Britain
Eindhoven	Netherlands
Essaouira	Morocco
Estocolmo-Skavsta	Sweden
Estocolmo-Vasteras	Sweden
Faro	Portugal
Fez	Morocco
Figari	France
Frankfurt-Hahn	Germany
Fuerteventura	Spain
Gdansk	Poland
Genova	Italy
Girona-Barcelona	Spain
Glasgow-International	Great-Britain
Glasgow-Prestwick	Great-Britain
Gothenburg-Landvetter	Sweden
Gran-Canaria	Spain
Grenoble	France
Hamburg	Germany
Haugesund	Norway
Ibiza	Spain
Jerez	Spain
Kalamata	Greece
Katowice	Poland
Kaunas	Lithuania
Kerry	Ireland
Knock-Irlanda-Oeste	Ireland
La-Rochelle	France
Lamezia	Italy
Lancarote	Spain
Lappeenranta	Finland
Leeds	Great-Britain
Leipzig	Germany
Lille	France
Limoges	France
Linz	Austria
Lisboa	Portugal
Liverpool	Great-Britain
Lodz	Poland
Londres-Gatwick	Great-Britain
Londres-Luton	Great-Britain
Londres-Stansted	Great-Britain
Lorient	France
Lourdes	France
Lublin	Poland
Maastricht	Netherlands
Madrid	Spain
Malaga	Spain
Malta	Malta
Manchester	Great-Britain
Marraquexe	Morocco
Marselha	France
Memmingen-Munique	Germany
Menorca	Spain
Milao-Bergamo	Italy
Montpellier	France
Munster	Germany
Murcia	Spain
Nador	Morocco
Nantes	France
Newcastle	Great-Britain
Nice	France
Nimes	France
Nuremberg	Germany
Osijek	Croacia
Oslo-Rygge	Norway
Oslo-Torp	Norway
Ostrava	Czech-Republic
Oujda	Morocco
Pafos	Cyprus
Palermo	Italy
Palma	Spain
Paris-Beauvais	France
Paris-Vatry	France
Parma	Italy
Patras-Araxos	Greece
Perpignan	France
Perugia	Italy
Pescara	Italy
Pisa	Italy
Plovdiv	Bulgaria
Podgorica	Montenegro
Poitiers	France
Ponta-Delgada	Portugal
Porto	Portugal
Poznan	Poland
Prague	Czech-Republic
Pula	Croacia
Rabat	Morocco
Reus-Barcelona	Spain
Rhodes	Greece
Riga	Latvia
Rijeka	Croacia
Rodez	France
Rome-Campino	Italy
Rome-Fiumicino	Italy
Rzeszow	Poland
Salonica	Greece
Salzburgo	Austria
Santander	Spain
Santiago	Spain
Santorini-National	Greece
Saragoca	Spain
Sevilha	Spain
Shannon	Ireland
Skelleftea	Sweden
St-Etienne	France
Strasbourg	France
Stuttgart	Germany
Szczecin	Poland
Tallinn	Estonia
Tampere	Finland
Tanger	Morocco
Tenerife-North	Spain
Tenerife-Sul	Spain
Tours	France
Trapani	Italy
Trieste	Italy
Turim	Italy
Valencia	Spain
Valladolid	Spain
Varsovia-Modlin	Poland
Vaxjo	Sweden
Veneza-Treviso	Italy
Verona	Italy
Vilnius	Lithuania
Wroclaw	Poland
Zadar	Croacia
Zakynthos	Greece
